8 8 3
#^# #^# 
#  $$^# 
    $   
    ### 
#  #$#  
 #     #
# #### #
# $$$$$$
