8 8 4
#^# # # 
#  $$ # 
  $^$   
    ### 
#  #$#  
 #     #
# #### #
#       
