7 7
#######
#     #
# #$# #
# # # #
#     #
#     #
#######